<classDeclStar>	E W_CLASS
<varDeclStar>	E W_INT EL_ID W_FLOAT EL_FLOAT
<funcDefStar>	E W_INT EL_ID W_FLOAT EL_FLOAT
<statementStar>	E EL_ID W_FOR W_PUT W_IF W_RETURN W_GET
<arraySizeStar>	E ORG_OPEN_BRACKET
<statBlock>	E ORG_OPEN_CURLY EL_ID W_FOR W_PUT W_IF W_RETURN W_GET
<arithExprPrime>	E OP_PLUS OP_OR OP_MINUS
<termPrime>	E OP_MULTIPLY OP_AND OP_DIVIDE
<idnestStar>	E EL_ID
<indiceStar>	E ORG_OPEN_BRACKET
<fParams>	E W_INT EL_ID W_FLOAT EL_FLOAT
<fParamsTailStar>	E PUNCT_COMMA
<aParams>	E EL_ID EL_INTEGER W_FLOAT EL_FLOAT OP_NOT OP_PLUS OP_MINUS ORG_OPEN_PAREN
<aParamsTailStar>	E PUNCT_COMMA
<openParen>	ORG_OPEN_PAREN
<closeParen>	ORG_CLOSE_PAREN
<openCurly>	ORG_OPEN_CURLY
<closeCurly>	ORG_CLOSE_CURLY
<openSquare>	ORG_OPEN_BRACKET
<closeSquare>	ORG_CLOSE_BRACKET
<commentLine>	ORG_COMMENT_LINE
<openComment>	ORG_COMMENT_OPEN
<closeComment>	ORG_COMMENT_CLOSE
<if>	W_IF
<then>	W_THEN
<else>	W_ELSE
<for>	W_FOR
<class>	W_CLASS
<int>	W_INT
<float>	W_FLOAT EL_FLOAT
<get>	W_GET
<put>	W_PUT
<return>	W_RETURN
<program>	W_PROGRAM
<equal>	OP_EQUAL
<notEqual>	OP_NOT_EQUAL
<lessThan>	OP_L_THAN
<greaterThan>	OP_G_THAN
<lessThanOrEqual>	OP_L_THAN_OR_EQUAL
<greaterThanOrEqual>	OP_G_THAN_OR_EQUAL
<plus>	OP_PLUS
<minus>	OP_MINUS
<multiply>	OP_MULTIPLY
<divide>	OP_DIVIDE
<assign>	OP_ASSIGN
<and>	OP_AND
<not>	OP_NOT
<or>	OP_OR
<semiCol>	PUNCT_SEMICOL
<comma>	PUNCT_COMMA
<dot>	PUNCT_DOT
<integer>	EL_INTEGER
<id>	EL_ID
<classDecl>	W_CLASS
<progBody>	W_PROGRAM
<funcBody>	ORG_OPEN_CURLY
<sign>	OP_PLUS OP_MINUS
<idnest>	EL_ID
<indice>	ORG_OPEN_BRACKET
<arraySize>	ORG_OPEN_BRACKET
<type>	W_INT EL_ID W_FLOAT EL_FLOAT
<fParamsTail>	PUNCT_COMMA
<aParamsTail>	PUNCT_COMMA
<assignOp>	OP_ASSIGN
<relOp>	OP_EQUAL OP_L_THAN OP_L_THAN_OR_EQUAL OP_NOT_EQUAL OP_G_THAN_OR_EQUAL OP_G_THAN
<addOp>	OP_PLUS OP_OR OP_MINUS
<multOp>	OP_MULTIPLY OP_AND OP_DIVIDE
<num>	EL_INTEGER W_FLOAT EL_FLOAT
<prog>	E W_CLASS
<funcHead>	W_INT EL_ID W_FLOAT EL_FLOAT
<varDecl>	W_INT EL_ID W_FLOAT EL_FLOAT
<variable>	E EL_ID
<funcDef>	W_INT EL_ID W_FLOAT EL_FLOAT
<assignStat>	E EL_ID
<factor>	E EL_ID EL_INTEGER W_FLOAT EL_FLOAT OP_NOT OP_PLUS OP_MINUS ORG_OPEN_PAREN
<statement>	E EL_ID W_FOR W_PUT W_IF W_RETURN W_GET
<term>	E EL_ID EL_INTEGER W_FLOAT EL_FLOAT OP_NOT OP_PLUS OP_MINUS ORG_OPEN_PAREN
<arithExpr>	E EL_ID EL_INTEGER W_FLOAT EL_FLOAT OP_NOT OP_PLUS OP_MINUS ORG_OPEN_PAREN
<expr>	E EL_ID EL_INTEGER W_FLOAT EL_FLOAT OP_NOT OP_PLUS OP_MINUS ORG_OPEN_PAREN
<relExpr>	E EL_ID EL_INTEGER W_FLOAT EL_FLOAT OP_NOT OP_PLUS OP_MINUS ORG_OPEN_PAREN