<prog>	$
<classDeclStar>	W_PROGRAM
<classDecl>	E, W_CLASS
<varDeclStar>	E, EL_ID, W_FOR, W_PUT, W_IF, W_RETURN, W_GET, W_INT, W_FLOAT, EL_FLOAT
<funcDefStar>	ORG_CLOSE_CURLY, $
<progBody>	$
<funcHead>	ORG_OPEN_CURLY
<funcDef>	E, W_INT, EL_ID, W_FLOAT, EL_FLOAT
<funcBody>	PUNCT_SEMICOL
<statementStar>	ORG_CLOSE_CURLY
<varDecl>	E, W_INT, EL_ID, W_FLOAT, EL_FLOAT
<arraySizeStar>	E, PUNCT_COMMA, PUNCT_SEMICOL
<statement>	E, EL_ID, W_FOR, W_PUT, W_IF, W_RETURN, W_GET, W_ELSE, PUNCT_SEMICOL
<assignStat>	PUNCT_SEMICOL, ORG_CLOSE_PAREN
<statBlock>	W_ELSE, PUNCT_SEMICOL
<expr>	E, PUNCT_COMMA, ORG_CLOSE_PAREN, PUNCT_SEMICOL
<relExpr>	PUNCT_SEMICOL, E, PUNCT_COMMA, ORG_CLOSE_PAREN
<arithExpr>	ORG_CLOSE_BRACKET, ORG_CLOSE_PAREN, OP_EQUAL, OP_L_THAN, OP_L_THAN_OR_EQUAL, OP_NOT_EQUAL, OP_G_THAN_OR_EQUAL, OP_G_THAN, PUNCT_SEMICOL, E, PUNCT_COMMA
<arithExprPrime>	ORG_CLOSE_BRACKET, ORG_CLOSE_PAREN, OP_EQUAL, OP_L_THAN, OP_L_THAN_OR_EQUAL, OP_NOT_EQUAL, OP_G_THAN_OR_EQUAL, OP_G_THAN, PUNCT_SEMICOL, E, PUNCT_COMMA
<sign>	E, EL_ID, EL_INTEGER, W_FLOAT, EL_FLOAT, OP_NOT, OP_PLUS, OP_MINUS, ORG_OPEN_PAREN
<term>	E, OP_PLUS, OP_OR, OP_MINUS
<termPrime>	E, OP_PLUS, OP_OR, OP_MINUS
<factor>	E, OP_MULTIPLY, OP_AND, OP_DIVIDE
<idnestStar>	EL_ID
<variable>	OP_ASSIGN, ORG_CLOSE_PAREN, E, OP_MULTIPLY, OP_AND, OP_DIVIDE
<indiceStar>	PUNCT_DOT, OP_ASSIGN, ORG_CLOSE_PAREN, E, OP_MULTIPLY, OP_AND, OP_DIVIDE
<idnest>	E, EL_ID
<indice>	E, ORG_OPEN_BRACKET
<arraySize>	E, ORG_OPEN_BRACKET
<type>	EL_ID
<fParams>	ORG_CLOSE_PAREN
<fParamsTailStar>	ORG_CLOSE_PAREN
<aParams>	ORG_CLOSE_PAREN
<aParamsTailStar>	ORG_CLOSE_PAREN
<fParamsTail>	E, PUNCT_COMMA
<aParamsTail>	E, PUNCT_COMMA
<assignOp>	E, EL_ID, EL_INTEGER, W_FLOAT, EL_FLOAT, OP_NOT, OP_PLUS, OP_MINUS, ORG_OPEN_PAREN
<relOp>	E, EL_ID, EL_INTEGER, W_FLOAT, EL_FLOAT, OP_NOT, OP_PLUS, OP_MINUS, ORG_OPEN_PAREN
<addOp>	E, EL_ID, EL_INTEGER, W_FLOAT, EL_FLOAT, OP_NOT, OP_PLUS, OP_MINUS, ORG_OPEN_PAREN
<multOp>	E, EL_ID, EL_INTEGER, W_FLOAT, EL_FLOAT, OP_NOT, OP_PLUS, OP_MINUS, ORG_OPEN_PAREN
<num>	E, OP_MULTIPLY, OP_AND, OP_DIVIDE
<openParen>	E, EL_ID, EL_INTEGER, W_FLOAT, EL_FLOAT, OP_NOT, OP_PLUS, OP_MINUS, ORG_OPEN_PAREN, W_INT
<closeParen>	W_THEN, E, ORG_OPEN_CURLY, EL_ID, W_FOR, W_PUT, W_IF, W_RETURN, W_GET, PUNCT_SEMICOL, OP_MULTIPLY, OP_AND, OP_DIVIDE
<openCurly>	E, EL_ID, W_FOR, W_PUT, W_IF, W_RETURN, W_GET, W_INT, W_FLOAT, EL_FLOAT
<closeCurly>	PUNCT_SEMICOL, W_ELSE
<openSquare>	EL_INTEGER, E, EL_ID, W_FLOAT, EL_FLOAT, OP_NOT, OP_PLUS, OP_MINUS, ORG_OPEN_PAREN
<closeSquare>	E, ORG_OPEN_BRACKET
<commentLine>	
<openComment>	
<closeComment>	
<if>	ORG_OPEN_PAREN
<then>	E, ORG_OPEN_CURLY, EL_ID, W_FOR, W_PUT, W_IF, W_RETURN, W_GET
<else>	E, ORG_OPEN_CURLY, EL_ID, W_FOR, W_PUT, W_IF, W_RETURN, W_GET
<for>	ORG_OPEN_PAREN
<class>	EL_ID
<int>	EL_ID
<float>	E, OP_MULTIPLY, OP_AND, OP_DIVIDE, EL_ID
<get>	ORG_OPEN_PAREN
<put>	ORG_OPEN_PAREN
<return>	ORG_OPEN_PAREN
<program>	ORG_OPEN_CURLY
<equal>	E, EL_ID, EL_INTEGER, W_FLOAT, EL_FLOAT, OP_NOT, OP_PLUS, OP_MINUS, ORG_OPEN_PAREN
<notEqual>	E, EL_ID, EL_INTEGER, W_FLOAT, EL_FLOAT, OP_NOT, OP_PLUS, OP_MINUS, ORG_OPEN_PAREN
<lessThan>	E, EL_ID, EL_INTEGER, W_FLOAT, EL_FLOAT, OP_NOT, OP_PLUS, OP_MINUS, ORG_OPEN_PAREN
<greaterThan>	E, EL_ID, EL_INTEGER, W_FLOAT, EL_FLOAT, OP_NOT, OP_PLUS, OP_MINUS, ORG_OPEN_PAREN
<lessThanOrEqual>	E, EL_ID, EL_INTEGER, W_FLOAT, EL_FLOAT, OP_NOT, OP_PLUS, OP_MINUS, ORG_OPEN_PAREN
<greaterThanOrEqual>	E, EL_ID, EL_INTEGER, W_FLOAT, EL_FLOAT, OP_NOT, OP_PLUS, OP_MINUS, ORG_OPEN_PAREN
<plus>	E, EL_ID, EL_INTEGER, W_FLOAT, EL_FLOAT, OP_NOT, OP_PLUS, OP_MINUS, ORG_OPEN_PAREN
<minus>	E, EL_ID, EL_INTEGER, W_FLOAT, EL_FLOAT, OP_NOT, OP_PLUS, OP_MINUS, ORG_OPEN_PAREN
<multiply>	E, EL_ID, EL_INTEGER, W_FLOAT, EL_FLOAT, OP_NOT, OP_PLUS, OP_MINUS, ORG_OPEN_PAREN
<divide>	E, EL_ID, EL_INTEGER, W_FLOAT, EL_FLOAT, OP_NOT, OP_PLUS, OP_MINUS, ORG_OPEN_PAREN
<assign>	E, EL_ID, EL_INTEGER, W_FLOAT, EL_FLOAT, OP_NOT, OP_PLUS, OP_MINUS, ORG_OPEN_PAREN
<and>	E, EL_ID, EL_INTEGER, W_FLOAT, EL_FLOAT, OP_NOT, OP_PLUS, OP_MINUS, ORG_OPEN_PAREN
<not>	E, EL_ID, EL_INTEGER, W_FLOAT, EL_FLOAT, OP_NOT, OP_PLUS, OP_MINUS, ORG_OPEN_PAREN
<or>	E, EL_ID, EL_INTEGER, W_FLOAT, EL_FLOAT, OP_NOT, OP_PLUS, OP_MINUS, ORG_OPEN_PAREN
<semiCol>	E, EL_ID, EL_INTEGER, W_FLOAT, EL_FLOAT, OP_NOT, OP_PLUS, OP_MINUS, ORG_OPEN_PAREN, W_INT, W_FOR, W_PUT, W_IF, W_RETURN, W_GET, W_ELSE, PUNCT_SEMICOL, W_CLASS
<comma>	E, EL_ID, EL_INTEGER, W_FLOAT, EL_FLOAT, OP_NOT, OP_PLUS, OP_MINUS, ORG_OPEN_PAREN, W_INT
<dot>	E, EL_ID
<integer>	ORG_CLOSE_BRACKET, E, OP_MULTIPLY, OP_AND, OP_DIVIDE
<id>	E, ORG_OPEN_BRACKET, ORG_OPEN_PAREN, OP_ASSIGN, ORG_OPEN_CURLY, EL_ID
